Access Mode=Режим доступа
Add another Path, Port, Variable, Label or Device=Добавьте другой путь, порт, переменную, метку или устройство
Add Configuration=Добавить конфигурацию
Add=Добавить
Additional Requirements=Дополнительные требования
Always=Всегда
App to Host=Приложение на хост
Application=Применение
apply update=применить обновление
Array must be Started to view Docker containers=Для просмотра контейнеров Docker необходимо **запустить** массив
Are you sure=Ты уверен
Autostart=Авто старт
Back=Обратно
Backup=Бэкап
Beta=Бета-версия
Books=Книги
By=В
Categories=Категории
Check for Updates=Проверить наличие обновлений
Cloud=Cloud
Config Type=Тип конфигурации
Configuration not found=Конфигурация не найдена
Connection Type=Тип подключения
Console shell command=Команда консольной оболочки
Container ID=ID Контейнера
Container Path=Путь Контейнера
Container Port=Порт Контейнера
Container Size=Размер Контейнера
Container=Контейнер
CPU Memory load=Загрузка процессора и памяти
CPU Pinning=Закрепление CPU
Created=Создано
Crypto Currency=Криптовалюта
Default Value=Значение по умолчанию
Device=Устройство
Display=Дисплей
DNS=DNS
Docker Containers=Docker Контейнеры
Docker Hub URL=URL-адрес Docker Hub
Docker Service failed to start=Не удалось запустить службу Docker
Downloaders=Загрузчики
Drivers=Драйвера
Edit Configuration=Изменить конфигурацию
Exited=Вышел
Extra Parameters=Дополнительные параметры
Fixed IP address=Фиксированный IP-адрес
force update=быстрое обновление
FTP=FTP
Game Servers=Игровые Серверы
healthy=здоровый
Hide Buttons=Скрыть кнопки
Hide docker allocations=Скрыть выделение Dockers
Hide more settings=Скрыть параметры
Home Automation=Автоматизация Дома
Host Path=Путь Хоста
Host Port=Порт Хоста
HT=HT
Icon URL=URL-адрес значка
Image ID=Образ ID
Key=Ключ
Label=Этикетка
Management=Менеджмент
MediaApp=MediaApp
MediaServer=Медиасервер
Messenger=Мессенджер
Missing parameters=Отсутствующие параметры
Music=Музыка
Network Type=Тип сети
No Docker containers installed=Контейнеры Docker не установлены
None Listed=Нет в списке
of=с
orphan image=устаревшие образы
Other=Прочие
Overview=Общие сведения
Path=Путь
Pause All=Приостановить все
Photos=Фотографии
Port Mappings=Отображение портов
Port=Port
Post Arguments=Аргументы публикации
Privileged=Привилегированный
Productivity=Трудоспособность
Project Page=Страница проекта
Proxy=Прокси
Pulling image=Вытягивание образа
Read Me First=Сначала Прочитай Меня
Read Only - Shared=Только чтение-Shared
Read Only - Slave=Только чтение-Slave
Read Only=Только Чтение
ReadWrite - Shared=Чтение / запись-Shared
ReadWrite - Slave=Чтение / запись-Slave
rebuild ready=перестроить готов
rebuilding=перестройка
Remove template=Удалить шаблон
Removing container=Удаление контейнера
Removing orphan image=Удаление устаревшего образа
Repository=Репозиторий
Required=Необходимый
Reset sorting=Сбросить сортировку
Resume All=Восстановить все
Save=Сберечь
Select a template=Выберите шаблон
Select categories=Выберите категории
Show docker allocations=Показать распределение докеров
Show more settings=Показать больше настроек
Stable=Стабильный
Start All=Запустить все
starting up containers=запуск контейнеров
Stop All=Остановить все
Stopping container=Остановка контейнера
Successfully removed container=Контейнер успешно удален
Successfully removed orphan image=Устаревший образ успешно удален
Successfully stopped container=Контейнер успешно остановлен
Support Thread=Тема Поддержка
Template URL=URL-адрес шаблона
Template=Шаблон
The command failed=Команда не удалась
The command finished successfully=Команда завершилась успешно
TOTAL DATA PULLED=ОБЩИЕ ДАННЫЕ
Total size=Общий размер
Unknown action=Неизвестное действие
Update All=Обновить ВСЕ
update ready=обновление готово
Value=Значение
Variable=Переменная
Video=Видео
Voip=Voip
Volume Mappings=Отображение Назад
wait=ждать
Was this container created using this plugin=Этот контейнер создан с помощью этого плагина
Web=Web
WebUI=WebUI
Writable=Возможна запись
