also remove image=также удалить образ
Apply=Применить
Are you sure=Вы уверены?
Cancel=Отмена
checking=проверка
Completely REMOVE=Полностью удалит
Console=Консоль
day=день
days=дней
disk image and definition=образ диска и определение
Disks=Диски
Donate=Задонатить
Done=Готово
Edit=Редактировать
Execution error=Ошибка выполнения
Force Stop=Принудительная остановка
Hibernate=Гибернация
Log for=Журнал для:
log=Журнал
Logs=Журнал
More Info=Больше информации
No=Нет
OK=Окей
Ok=Окей
Pause=Пауза
Proceed=Продолжить
Project Page=Страница проекта
Read Me First=Прочитай меня сначала
Remove container=Удалить контейнер
Remove definition=Удалить определение
Remove image=Удалить образ
Remove VM=Удалить VM
Remove=Удалить
Restart=Перезапустить
Resume=Восстановить
Start=Начать
Stop=Остановить
Support=Поддержка
Update container=Обновить контейнер
Update=Обновить
Updating all Containers=Обновить все контейнеры
Updating the container=Обновить контейнер
VNC Remote=Управление по VNC
WebUI=WebUI
Yes, delete it=Да, удалить!
Yes, update it=Да, обновить!
Yes=Yes

; footer messages
Array Copying=Копирование массива
Array Clearing=Очистка массива
Array Starting=Запуск массива
Array Stopping=Остановка массива
Mounting disks=Монтаж дисков
Retry unmounting user shares=Повторить попытку демонтирования общих пользователей
Spinning up all drives=Раскрутка всех дисков
Stale configuration=Устаревшая конфигурация
Starting services=Запуск сервиса
Stopping services=Остановка сервиса
Starting Recycle Bin=Запуск очистки корзины
Stopping Recycle Bin=Остановка очистки корзины
Sync filesystems=Синхронизация файловых систем
Unmounting disks=Размонтирование дисков
Autostart disabled=Автозапуск выключен
Missing encryption key=Отсутствует ключ шифрования
Opening encrypted volumes=Открытие зашифрованных томов

; docker variables
Container Path=Путь контейнера
Container Port=Порт контейнера
Container Variable=Переменная контейнера
Container Label=Метка контейнера
Container Device=Устройство контейнера
