A format is NEVER part of a data recovery or disk rebuild process and if done in such circumstances will normally lead to loss of all data on the disks being formatted=Форматирование **НИКОГДА** не является частью процесса восстановления данных или восстановления диска, и если это сделать при таких обстоятельствах, обычно приведет к потере всех данных на дисках, которые форматируются.
Aborted=Прервано
Action=Действие
Add=Добавить
Add Pool=Добавить пул
All existing data on this device will be OVERWRITTEN when array is Started=Все имеющиеся данные на этом устройстве будут перезаписаны после запуска массива
Array Devices=Устройства массива
Array of %s devices=Массив устройств %s
Array Operation=Операция с массивом
Attribute Name=Название атрибута
Attributes=Атрибуты
auto=авто
Balance Status=Состояние баланса
Balance=Баланс
Blacklisted=В черном списке
Boot Device=Устройство загрузки
Boot system in UEFI mode=Загрузка системы в режиме UEFI
btrfs balance status=состояние баланса btrfs
btrfs check status=btrfs проверить статус
btrfs filesystem df=Файловая система btrfs df
BTRFS operation is running=Запущена операция BTRFS
btrfs scrub status=Статус очистки btrfs
Can not read attributes=Не могу прочитать атрибуты
Can not read capabilities=Не могу прочитать возможности
Can not read identification=Не могу прочитать идентификацию
Canceled=Отменено
Cannot contact key-server Please check your=Невозможно связаться с сервером ключей. Пожалуйста, проверьте свой
Capabilities=Возможности
Check Filesystem Status=Проверьте состояние файловой системы
Clear Stats=Очистить статистику
Clearing in progress=Продолжается очищение
Click on FLASH above this message=Нажмите на **FLASH** над этим сообщением
Click to spin down device=Нажмите, чтобы раскрутить устройство
Click to spin up device=Нажмите, чтобы развернуть устройство
Comments=Комментарии
complete=завершено
completed=завершено
Completed without error=Выполнено без ошибок
Configuration valid=Конфигурация действительна
Convert to raid0 mode=Перевести в режим raid0
Convert to raid1 mode=Перевести в режим raid1
Convert to raid10 mode=Перевести в режим raid10
Convert to raid1c3 mode=Перевести в режим raid1c3
Convert to raid1c4 mode=Перевести в режим raid1c4
Convert to raid5 mode see help=Перейти в режим raid5 *смотрите справку
Convert to raid6 mode see help=Перейти в режим raid6 *смотрите справку
Convert to single mode=Перевести в одиночный режим
Copying=Копирование
corrected=исправленный
Create an empty file system on the disks shown as Unmountable discarding all data currently on the disks and update parity to reflect this=Создайте пустую файловую систему на дисках, которые отображаются как **Несмонтированные**, отвергая все данные на дисках, и обновите парити, чтобы отразить это
Creating Flash backup=Создание резервной копии Flash
creating Flash backup zip file this may take several minutes=создание ZIP-файла резервной копии Flash (это может занять несколько минут)
Creation error=Ошибка создания
Critical disk temperature threshold=Критический порог температуры диска
Critical disk utilization threshold=Критический порог использования диска
Current operation %s on %s=Текущая операция %s на **%s**
Current position=Текущая позиция
Custom attributes use comma to separate numbers=Специальные атрибуты (используйте запятую для разделения чисел)
Data-Rebuild in progress=Выполняется восстановление данных
Date of purchase=Дата покупки
Date=Дата
Delete Pool=Удалить Пул
detected=обнаружено
Device encrypted and unlocked=Устройство зашифровано и разблокировано
Device encrypted=Устройство зашифровано
Device is part of a pool=Устройство является частью пула
Device locked unknown error=Устройство заблокировано: неизвестная ошибка
Device locked wrong encryption key=Устройство заблокировано: неправильный ключ шифрования
Device to be encrypted=Устройство для шифрования
Disable Spin down delay to run a SMART extended self-test=Выключите **Задержку вращения**, чтобы запустить расширенное самотестирование SMART
Disk in parity slot is not biggest=Диск в слоте паритета не самый большой
Disk Log Information=Информация о дисковом журнале
Disk-Clear in progress=Выполняется очистка диска
Do not use reserved names=Не используйте зарезервированные имена
Do not use user share names=Не используйте имена пользователей общего доступа
Download SMART report=Скачать отчет SMART
Dual parity valid requires ALL disks in their original slots=*Dual parity*нужны **ВСЕ** диски в оригинальных слотах
Elapsed time=Потраченное время
Enable user share assignment=Включить назначение общего доступа пользователям
enter disk index and device name as applicable to your controller=введите индекс диска и название устройства в соответствии с вашим контроллером
Erase Device Content=Стереть содержимое устройства
encrypted=зашифрованный
Encryption input=Вход шифрования
Encryption status=Статус шифрования
Enter new key=Введите новый ключ
Errors occurred - Check SMART report=Произошли ошибки-проверьте отчет SMART
Estimated finish=Ориентировочная обработка
Estimated speed=Расчетная скорость
Existing content is permanently lost=Существующее содержимое окончательно потеряно
Failed=Не удалось
Feature=Особенность
File system status=Состояние файловой системы
File system type=Тип файловой системы
Finding %s error=Найдено: ошибка **%s**
Finding %s errors=Обнаружено: **%s** ошибок
Flag=Флаг
Flash backup=Flash-резервное копирование
Flash device is set as public share=Flash-устройство установлено как общедоступное
Flash Device Settings=Настройка Flash-устройства
Format Unmountable disks=Форматировать немонтированные диски
Formatting=Форматирование
formatting=форматирование
Free=Свободно
FS=FS
Global Configuration=Глобальная конфигурация
Hide=Скрыть
Identification=Идентификация
Identity=Идентичность
if checked, Start array but do not mount disks=если помечено, запустить массив, но не монтировать диски
If this is a new array, move the largest disk into the parity slot=Если это новый массив, переместите самый большой диск в слот *parity*
If you are adding a new disk or replacing a disabled disk, try Parity-Swap=Если вы добавляете новый диск или заменяете выключенный диск, попробуйте Parity-Swap
Information=Информация
Insufficient free disk space available=Недостаточно свободного места на диске
Interrupted=Прерванный
Invalid configuration=Недействительная конфигурация
invalid device=недействительное устройство
invalid devices=недействительные устройства
Invalid expansion=Недействительное расширение
Invalid pool name=Недействительное название пула
Invalid, missing or expired=Недействительный, отсутствующий или просроченный
is only available when array is Started in Maintenance mode=доступен только тогда, когда массив запущен в режиме **обслуживания**
is only available when array is Started=доступен только тогда, когда массив запущен
Keyfile=Файл ключа
Last check completed on %s=Последняя проверка завершена **%s**
Last check incomplete on %s=Последняя проверка не завершена **%s**
Last checked on %s=Последний раз проверено **%s**
Last SMART test result=Результат последнего теста SMART
Maintenance mode=Режим обслуживания
Maintenance Mode=Режим Обслуживания
Maintenance=Обслуживание
Manufacturing date=Дата изготовления
Menu View=Просмотр меню
Minimum free space=Минимум свободного места
Missing Cache disk=Отсутствует Кэш-Диск
Missing disk=Отсутствует диск
Missing key=Отсутствует ключ
Missing=Отсутствует
Mounted=Смонтированная
Mover is running=Перенос запущен
network settings=настройка сети
next device=следующее устройство
New data disks detected=Обнаружены новые диски с данными
No array data disks have been assigned=Диски с данными массива не предназначены
No data disks=Нет дисков с данными
No parity check history present=Нет истории проверки на четность
No self-tests logged on this disk=На этом диске не зарегистрировано ни одного самотестирования
Not installed=Не установлено
OK=OK
Once copy completes, the array may be Started, to initiate Data-Rebuild of the disabled disk=После завершения копирования массив можно запустить, чтобы инициировать восстановление данных выключенного диска
operation=операция
Options see Help=Параметры (см. справку)
Otherwise use the keyfile method for UTF8 input=В противном случае используйте метод **файл ключа** для ввода UTF8
Parity disks content will be overwritten=Содержимое диска (ов) *Parity* будет перезаписано
Parity is already valid=Парити уже действителен
Parity operation is running=Выполняется операция парити
Parity valid requires ALL disks to have their original content=Для проверки четности требуется, чтобы все диски имели исходное содержимое
Parity-Check in progress=Выполняется проверка парити
Parity Operation History=История операций парити
ParityRead-Check History=История чтения-проверки Парити
Parity-SyncData-Rebuild in progress=Выполняется синхронизация парити/перестройка данных
Parity-Sync in progress=Выполняется синхронизация парити
Partition format=Формат раздела
Partition size=Размер раздела
Passed=Принято
Passphrase=Кодовая фраза
Perform full balance=Выполните полный баланс
Permit UEFI boot mode=Разрешить режим загрузки UEFI
Please change share SMB security=Пожалуйста, измените совместную безопасность SMB
Please check your system settings to support UEFI boot mode=Проверьте настройки системы для поддержки режима загрузки UEFI
Pool Devices=Пул устройств
Pool name already exists=Название пула уже существует
Pool of %s devices=Пул устройств %s
Preclear in progress=Выполняется предварительная очистка
previous device=предыдущее устройство
Printable Characters Only=Только для печати символов
Proceed to start=Перейти к запуску
Raw Value=Значение Raw
Raw View=Посмотреть Raw
Read-Check in progress=Продолжается чтение-проверка
Reading=Чтение
Reboot in safe mode=Перезагрузка в безопасном режиме
registration key=ключ регистрации
Registration Key Manager=Менеджер ключей регистрации
reiserfsck status=статус reiserfsck
Rename Pool=Переименовать Пул
Repair corrupted blocks=Восстановить поврежденные блоки
Replacement disk installed=Установлен заменяемый диск
Replacement disk is too small=Заменяемый диск слишком мал
Retype passphrase=Повторно введите кодовую фразу
Schedule=Расписание
Scrub Status=Статус Scrub
Scrub=Scrub
See %s Settings=Смотрите настройки %s
self-test in progress=идет самопроверка
Self-Test=Самопроверка
Server boot mode=Режим загрузки сервера
Set default boot menu=Установить меню загрузки по умолчанию
show passphrase=показать кодовую фразу
Show=Показать
Slots=Слоты
SMART attribute notifications=Уведомления атрибутов SMART
SMART controller type=Тип контроллера SMART
SMART error log=Журнал ошибок SMART
SMART extended self-test=Расширенная самопроверка SMART
SMART health-check failed=Ошибка проверки работоспособности SMART
SMART notification tolerance level=Уровень толерантности уведомлений SMART
SMART notification value=Значение уведомлений SMART
SMART self-test history=История самотестирования SMART
SMART self-test in progress=Идет самопроверка SMART
SMART Settings=Настройка SMART
SMART short self-test=Краткая самопроверка SMART
SMART status=SMART статус
Speed=Скорость
Spin down delay=Задержка вращения
Spin Down=Остановить Вращение
Spin Up=Запустить Вращение
Spinup groups=Согруппа (ы)
Started, array protected=Запущено, массив защищен
Started, array unprotected=Запущено, массив незащищен
Started, clearing=Начали, очищение
Started, formatting=Начали форматирование
Starting, copying=Начало, копирование
Starting=Начало
Stopping=Остановка
Sync errors=Ошибки синхронизации
Sync errors corrected=Исправлены ошибки синхронизации
Sync errors detected=Обнаружены ошибки синхронизации
Sync=Синхронизировать
Syslinux Configuration=Конфигурация Syslinux
Syslinux configuration=конфигурация Syslinux
Temp=Temp
The array will be immediately available, but unprotected since parity has not been assigned=Массив будет немедленно доступен, но незащищен, поскольку четность не была назначена
The array will be immediately available, but unprotected until Parity-Sync completes=Массив будет немедленно доступен, но **незащищен** до тех пор, пока синхронизация парити не будет завершена
The replacement disk must be as big or bigger than the original=Сменный диск должен быть таким же или больше оригинального
This is typically done when a new disk is added to the array to get it ready for files to be written to it=Обычно это делается, когда в массив добавляется новый диск, чтобы подготовить его к записи файлов
This Unraid OS release has been withdrawn and may no longer be used Please=Этот выпуск Unraid OS был отозван и больше не может использоваться. Пожалуйста
This will ERASE ALL device content=Это действие СОТРЕТ все содержимое устройства
This will ERASE content of ALL devices in the pool=Это стирает содержимое всех устройств в пуле
This will reboot the system=Это приведет к перезагрузке системы
This will shutdown the system=Это отключит систему
This will stop the array=Это остановит массив
This will stop the running operation=Это остановит запущенную операцию
Threshold=Порог
Title=Название
To confirm your action type %s=Чтобы подтвердить тип действия: %s
Toggle readswrites display=Переключатель отображения чтения / записи
Too many attached devices Please consider upgrading your=Слишком много подключенных устройств. Пожалуйста, подумайте об обновлении своего
Too many wrong andor missing disks=Много неправильных и / или отсутствующих дисков
Total size=Общий размер
Unassign ALL devices to delete this pool=Отменить назначение **ВСЕМ** устройствам, чтобы удалить этот пул
Unassigned Devices=Неназначенные устройства
unavailable no parity-check entries logged=недоступно (записи проверки четности не зарегистрированы)
Unavailable - disk must be spun up=Недоступно-диск нужно раскрутить
Unavailable=Недоступно
Unclean shutdown detected=Обнаружено нечистое выключение
Unmountable disk present=Присутствует немонтированный диск
Unmountable disks present=Присутствуют немонтированные диски
Unmountable Encrypted volume present=Несмонтированный: присутствует зашифрованный том
Unmountable Missing encryption key=Несмонтированный: отсутствует ключ шифрования
Unmountable No file system=Несмонтированный: нет файловой системы
Unmountable No pool uuid=Несмонтированный: нет пула uuid
Unmountable not btrfs pool=Несмонтированный: не пула btrfs
Unmountable Unsupported or no file system=Несмонтированный: не поддерживается или отсутствует файловая система
Unmountable Volume not encrypted=Несмонтированный, поэтому не зашифрован
Unmounted=Размонтированный
Upgrading diskswapping parity=Обновление парити диска/подкачки
Use ASCII characters from space to tilde=Используйте символы **ASCII** от пробела " " до Тильды "~"
Use Default=Использовать по Умолчанию
Use default=Использовать по умолчанию
Use only lowercase with no special characters or leadingtrailing digits=Используйте только нижний регистр без специальных символов или начальных/конечных цифр
use printable characters only=используйте только печатные символы
Used=Использовано
Value=Значение
WARNING canceling may leave the array unprotected=Предупреждение: отмена может оставить массив незащищенным
Warning disk temperature threshold=Предупреждение о пороге температуры диска
Warning disk utilization threshold=Предупреждение о пороге использования диска
WARNING=ВНИМАНИЕ
Warranty period=Гарантийный срок
will activate a clean system power down=активирует *чистое* отключение питания системы
will activate a clean system reset=активирует *чистый* перезапуск системы
will bring the array on-line and start Clearing new data disks=переведет массив в режиме онлайн и начнет **Очистка** новых дисков с данными
will bring the array on-line and start Data-Rebuild=переведет массив в режим работы и начнет **Восстановление данных**
will bring the array on-line and start Disk-Clear of new data disks=переведет массив в режиме онлайн и начнет **Очистка диска** новых дисков с данными
will bring the array on-line and start Parity-Check=переведет массив в режиме онлайн и начнет **Проверка четности**
will bring the array on-line and start Parity-Sync=переведет массив в режиме онлайн и запустить **Синхронизация Парити**
will bring the array on-line and start Parity-Sync andor Data-Rebuild=переведет массив в режим работы и запустить **Синхронизацию Парити** и / или **Восстановление данных**
will bring the array on-line=Переведет массив в режим онлайн
will copy the parity information to the new parity disk=скопирует информацию о четности на новый диск *парити*
will create a file system in all Unmountable disks=создать файловую систему на всех **Отмонтированных** дисках
will delete the encryption keyfile=удалит ключевой файл шифрования
will disable the missing disk and then bring the array on-line Install a replacement disk as soon as possible=выключит недостающий диск, а затем переведет массив в режим работы. Установите заменяемый диск как можно скорее
will expand the file system of the data disk if possible then bring the array on-line and start Data-Rebuild=расширит файловую систему диска данных (если возможно); затем введет массив в режим онлайн и запустит Восстановление данных
will immediately clear all disk statistics=немедленно очистит всю статистику диска
will immediately invoke the Mover=немедленно вызовет перенос
will immediately spin down all disks=немедленно остановит все диски
will immediately spin up all disks=немедленно запустит все диски
will pause the Clearing=приостановит очистку
will pause the Parity-Check=приостановит проверку на четность
will pause the Parity-SyncData-Rebuild=приостановит Parity-Sync / Data-Rebuild
will pause the Read-Check=приостановит проверку чтения
will pause Data-Rebuild=приостановит восстановление данных
will pause Disk-Clear=приостановит очистку диска
will pause Parity-Check=приостановит проверку на четность
will pause Parity-Sync=приостановит Синхронизацию Парити
will pause Read-Check=приостановит проверку чтения
will record all disk information and bring the array on-line=запишет всю информацию о диске и переведет массив в режим онлайн
will record all disk information, bring the array on-line, and start Parity-Sync=запишет всю информацию о диске, переведет массив в режиме онлайн и запустит Синхронизацию Парити
will remove the missing cache disk and then bring the array on-line=удалит недостающий кэш-диск, а затем переведет массив в режим онлайн
will resume the paused Clearing=возобновит приостановленную очистку
will resume the paused Parity-Check=возобновит приостановленную проверку четности
will resume the paused Parity-SyncData-Rebuild=возобновит приостановленную Синхронизацию Парити / Восстановление данных
will resume the paused Read-Check=возобновит приостановленную проверку чтения
will resume Data-Rebuild=возобновит восстановление данных
will resume Disk-Clear=возобновит очистку диска
will resume Parity-Check=возобновит проверку четности
will resume Parity-Sync=возобновит Синхронизацию Парити
will resume Read-Check=возобновит проверку чтения
will start Clearing new data disks=начнет **очистку** новых дисков с данными
will start Parity-Sync andor Data-Rebuild=запуск **Синхронизация Парити** и / или **Восстановление данных**
will start Disk-Clear of new data disks=начнет **Очистка диска** новых дисков с данными
will start Parity-Check=начнется **Проверка Парити**
will start Data-Rebuild=начнется **Восстановление данных**
will start Parity-Sync=запустится **Синхронизация Парити**
will start Read-Check of all array disks=начнется **Проверка Чтения** всех дисков массива
will stop Parity-SyncData-Rebuild=остановит Синхронизацию Парити / Восстановление данных
will stop the Parity-Check=остановит проверку на четность
will stop the Read-Check=остановит проверку чтения
will stop Clearing=остановит очистку
will stop Disk-Clear=остановит очищение диска
will stop Data-Rebuild=остановит восстановление данных
will stop Parity-Check=остановит проверку паритета
will stop Parity-Sync=остановит синхронизацию паритета
will stop Read-Check=остановит проверку чтения
will take the array off-line=выведет массив из сети
Worst=Похуже
Write corrections to parity=Записать поправки к парити
Writes=Пишет
Wrong key=Неправильный ключ
xfs_repair status=статус xfs_repair
You may not add new disks and also remove existing disks=Вы не можете добавлять новые диски, а также удалять имеющиеся диски
your server=ваш сервер

; Sleep plugin translations
Check this=Проверь это
for more information=для получения дополнительной информации
Make sure your server supports S3 sleep=Убедитесь, что ваш сервер поддерживает режим сна **S3**
Sleep will immediately put the server in sleep mode=**Сон** немедленно переведет сервер в спящий режим
Sleeping=Спящий
System in sleep mode=Система в спящем режиме
This will put the system in sleep mode=Это переведет систему в спящий режим
wiki entry=запись wiki
