%s ago=%s назад
%s is out of range minimum 1 maximum 65535=%s находится вне диапазона, минимум 1 максимум 65535
12 hours=12 часов
24 hours=24 часа
8023ad=802.3ad
Accumulation duration=Продолжительность накопления
Accumulation frequency=Частота накопления
Activate=Активировать
Activated=Активирован
Activating=Активация
Active Directory Settings=Настройка Active Directory
Active Directory=Active Directory
active-backup=активное резервное копирование
AD account login=Вход в учетную запись AD
AD account password=Пароль учетной записи AD
AD domain name=Доменное имя AD
AD initial group=AD начальная группа
AD initial owner=Первоначальный владелец AD
AD join status=статус присоединения к AD
AD short domain name=AD короткое доменное имя
Add Peer=Добавить Узел
Add Route=Добавить маршрут
Add Tunnel=Добавить туннель
Add VLAN=Добавить VLAN
Advanced=Расширенный
Agent function=Функция агента
Agents=Агенты
Alerts=Оповещение
Allow Remote Access=Разрешить удаленный доступ
Allow=Позволить
and, the first and last characters must be alphanumeric=и первый и последний символы должны быть буквенно-цифровыми
and=и
APC UPS Daemon user manual=Руководство пользователя APC UPS Daemon
APCsmart=APCsmart
Apply to activate Docker after Array is Started=Применить, чтобы активировать Docker после запуска массива
Apply to activate VMs after Array is Started=Применить для активации виртуальных машин после запуска массива
Applying=Применение
Array must be Stopped to change=Чтобы изменить массив, необходимо **остановить**
Array status notification=Сообщение о состоянии массива
Array status=Состояние массива
Assignment error=Ошибка задачи
Attention=Внимание
Attribute=Атрибут
Authentication method=Метод аутентификации
automatic=автоматический
Autostart=Авто старт
Available notifications=Доступные уведомления
Balance schedule=График баланса
balance-alb=баланс-alb
balance-rr=баланс-rr
balance-tlb=баланс-tlb
balance-xor=баланс-xor
Bar color - Text=Панель (цвет) - Текст
Bar color=Панель (цвет)
Bar gray - Text=Панель (серая) - Текст
Bar gray=Панель (серая)
Basic=Основный
Battery Charge=Заряд батареи
Battery level to initiate shutdown=Уровень батареи для начала выключения
bfq=bfq
Block group usage=Блокировать использование группы
Bonding members of=Объединение членов
Bonding mode=Режим склеивания
Both=Оба
bottom-left=нижний левый
bottom-right=нижний правый
Bridging members of=Объединение членов
broadcast=транслировать
Browser=Браузер
btrfs filesystem show=Показ файловой системы btrfs
btrfs scrub status=Статус очистки btrfs
btrfs vDisk=btrfs vDisk
Cache disk not enabled=Cache-диск не включен
Cache Settings=Настройка Кэша
Cannot provision cert that would overwrite your existing custom cert at=Невозможно предоставить сертификат, который заменил бы ваш существующий специальный сертификат по адресу
Cannot renew cert until within 30 days of expiry=Нельзя восстановить сертификат в течение 30 дней после окончания срока действия
Cannot renew a custom cert at=Невозможно восстановить специальный сертификат на
CA-signed certificate file=Файл сертификата, с подписью CA
Celsius=Цельсия
center=центр
Certificate expiration=Срок действия сертификата
Certificate issuer=Эмитент сертификата
Certificate subject=Тема сертификата
Certificate will not renew unless you are signed in to Unraidnet=Сертификат не будет обновлен, если вы не войдете в систему Unraid.net
Changes=Изменения
Check cable=Проверьте кабель
Check four times a day=Проверка четыре раза в день
Check once a day=Проверка один раз в день
Check once a month=Проверка раз в месяц
Check once a week=Проверка раз в неделю
Check twice a day=Проверка дважды в день
Checking=Проверка
CIDR optional=CIDR необязательный
Click here to see the Unraid Wiki for more information=Нажмите здесь, чтобы просмотреть Unraid Wiki для получения дополнительной информации
Click to invoke the Mover=Нажмите, чтобы вызвать перемещение
Click to select PNG file=Нажмите, чтобы выбрать файл PNG
Click to Select=Нажмите, чтобы выбрать
Comma separated list of IPv4 and IPv6 IP addresses=Список IP-адресов IPv4 и IPv6, разделенных запятыми
configure your router with a static route of=настройте свой маршрутизатор с помощью статического маршрута
configure your router with port forwarding of port=настройте маршрутизатор с переадресацией порта
configuring interface=настройка интерфейса
Confirm array stop command=Подтверждать команду остановки массива
Confirm reboot powerdown commands=Подтверждать команды перезагрузки и выключения питания
Confirm sleep command=Подтвердить команду сна
Confirmations=Подтверждение
connect to any device on the VPN tunnel=подключиться к любому устройству в туннеле VPN
connect to this server using IP address=подключиться к этому серверу с помощью IP-адреса
Container=Контейнер
Content=Содержание
Correct file system errors=Исправить ошибки файловой системы
CPU Isolation A reboot is required to apply changes=Изоляция CPU: для применения изменений требуется перезагрузка
CPU isolation is prohibited while system is running in SAFE MODE=Изоляция CPU запрещена, когда система работает в безопасном режиме
CPU Isolation=Изоляция CPU
CPU Pinning Docker=Закрепление CPU в Docker
CPU Pinning VM=Закрепление CPU в VM
CPU Pinning=Закрепление CPU
CRAM-MD5=CRAM-MD5
Cumulative parity check=Кумулятивная проверка на четность
Current date and time=Текущая дата и время
Current usage ratio=Текущий коэффициент использования
Custom attributes use comma to separate numbers=Специальные атрибуты (используйте запятую для разделения чисел)
Custom banner=Специальный баннер
Custom UPS cable=Специальный кабель UPS
Custom=Специальный
custom=специальный
D comma G dot=[D] запятая : [G] точка
D comma G none=[D] запятая : [G] никакой
D comma G space=[D] запятая : [G] пробел
D dot G comma=[D] точка : [G] запятая
D dot G none=[D] точка: [G] никакой
D dot G space=[D] точка : [G] пробел
Daily=Ежедневно
Data received=Данные получены
Data sent=Данные отправлены
Date and Time=Дата и время
Date format=Формат даты
Day of the month=День Луны
Day of the week=День недели
Day, D Month YYYY=День, Д месяц гггг
Day, DD.MM.YYYY=День, ДД.ММ.РРРР
Day, DD-MM-YYYY=День ДД-ММ-ГГГГ
Day, MMDDYYYY=День, ММ/ДД/ГГГГ
Day, Month D, YYYY=День, месяц Д, ГГГГ
Day, YYYY Month D=День, РРРР месяц Д
Day, YYYY-MM-DD=День, ГГГГ-ММ-ДД
DD-MM-YYYY=ДД-ММ-ГГГГ
Deactivate=Деактивировать
Deactivating=Деактивация
Default appdata storage location=Место хранения данных программы по умолчанию
Default critical disk temperature threshold=Пороговое значение критической температуры диска по умолчанию
Default critical disk utilization threshold=Пороговое значение критического использования диска по умолчанию
Default file system=Файловая система по умолчанию
Default ISO storage path=Стандартный путь хранения ISO
Default network bridge=Сетевой мост по умолчанию
Default partition format=Формат раздела по умолчанию
Default SMART attribute notifications=Уведомления атрибутов SMART по умолчанию
Default SMART controller type=Тип контроллера SMART по умолчанию
Default SMART notification tolerance level=Уровень допуска уведомлений SMART по умолчанию
Default SMART notification value=Значение уведомления SMART по умолчанию
Default spin down delay=Задержка вращения по умолчанию
Default VM storage path=Путь к хранению VM по умолчанию
Default warning disk temperature threshold=Пороговое значение температуры диска с предупреждением по умолчанию
Default warning disk utilization threshold=Типичный порог загрузки диска
Default Windows VirtIO driver ISO=ISO драйвер Windows VirtIO по умолчанию
Define a TLS certificate=Определите сертификат TLS
Delete directory=Удалить каталог
Delete Image File=Удалить файл образа
Delete Peer=Удалить Узел
Delete Tunnel=Удалить туннель
Delete tunnel failed=Не удалось удалить туннель
Delete vDisk file=Удалить файл vDisk
Delete VLAN=Удалить VLAN
Deny=Воспротивиться
Desired MTU=Желаемый MTU
Detailed=Детально
Device=Устройство
DHCP pool=Пул DHCP
directory=каталог
Disk Settings=Настройка Диска
Display array totals=Отобразить итоги массива
Display device name=Отобразить название устройства
Display position=Положение дисплея
Display Settings=Настройка дисплея
Display world-wide-name in device ID=Отображать всемирное название в идентификаторе устройства
DNS Propagation is PENDING=Распространение DNS ожидает
DNS Rebinding Protection is ENABLED=Защита от повторного подключения DNS включена
DNS servers=DNS-серверы
docker containers on custom networks need static routing=Докер-контейнеры в пользовательских сетях нуждаются в статической маршрутизации
Docker custom network type=Специальный тип сети Docker
Docker data-root=Корень данных Docker
Docker directory=Каталог Docker
Docker LOG maximum file size=Максимальный размер файла Log Docker
Docker LOG number of files=Количество файлов в журнале Docker
Docker LOG rotation=Ротация журнала Docker
Docker only=Только Docker
Docker service=Сервис Docker
Docker Stop Timeout=Тайм-аут остановки Docker
Docker update notification=Уведомление об обновлении Docker
Docker update=Обновление Docker
Docker vDisk location=Расположение Docker vDisk
Docker vDisk size=Размер vDisk Docker
Docker version=Версия Docker
Docker VMs=Docker + VMs
Docker volume info=Информация об объеме Docker
Docker will be available after Array is Started=Docker будет доступен после запуска массива
Docker=Docker
Download Windows VirtIO driver ISO=Загрузите драйвер ISO Windows VirtIO
Downloading=Загрузка
Downstream=нисходящем направлении
Drag-n-drop a PNG file or click the image at the left=Перетащите файл PNG или щелкните на изображение слева
Dumb=Тупой
Duplicate port entered=Введен дубликат порта
Dynamix color theme=Тема цветов Dynamix
eg=например
Email recipients=Получатели электронной почты
Email subject prefix=Префикс темы электронного письма
Email=Электронная почта
enable advanced settings view=включить просмотр расширенных настроек
Enable auto start=Включить автозапуск
Enable bonding=Включить связывание
Enable bridging=Включить переход
Enable disk shares=Включить общие диски
Enable Docker=Включите Docker
Enable NetBIOS=Включите NetBIOS
Enable NFS=Включите NFS
Enable SMB=Включить SMB
Enable SMB Multi Channel=Включить многоканальный SMB
Enable spinup groups=Включить группы раскрутки
Enable user shares=Включить общий доступ пользователей
Enable VLANs=Включить VLAN
Enable VMs=Включить VMs
Enable WSD=Включить WSD
encrypted=зашифрованный
Enhanced macOS interoperability=Улучшенная совместимость с macOS
ensure the peer network is different from=убедитесь, что одноранговая сеть отличается от
ensure the peer networks are different from=убедитесь, что одноранговые сети отличаются от
Enter route + gateway + metric=Введите маршрут + шлюз + метрику
Ether=
Ethernet Port=Порт Ethernet
Event=Событие
Every 2 hours=Каждые 2 часа
Every 3 hours=Каждые 3 часа
Every 4 hours=Каждые 4 часа
Every 6 hours=Каждые 5 часов
Every 8 hours=Каждые 6 часов
Every day=Каждый день
Every hour=Ежечасно
Every month=Ежемесячно
Every week=Еженедельно
exceeds Disk Shutdown=превышает выключение диска
Excluded disks=Исключены диск(ы)
Execution error=Ошибка выполнения
Fahrenheit=Фаренгейта
Failed to open=Не удалось открыть
Failed to stop=Не удалось остановить
Failure to do so may result in your docker image suffering corruption at a later time=Если этого не сделать, это может привести к тому, что ваш образ Docker позже будет поврежден
First day=Первый день
First week=Первая неделя
Flash backup=Резервное копирование Flash
Font size=Размер шрифта
Fourth week=Четвертая неделя
FTP server=FTP-сервер
FTP Server=FTP-Сервер
FTP users=Пользователь(и) FTP
Full Balance recommended=Рекомендуется полный баланс
gateway name or address=имя или адрес шлюза
Gateway=Шлюз
Generate Key=Сгенерировать ключ
Generate Keypair=Создать пару ключей
Global Share Settings=Глобальные настройки совместного доступа
Global SMART Settings=Глобальные настройки SMART
Header custom background color=Пользовательский цвет фона заголовка
Header custom meta text color=Цвет собственного метатекста заголовка
Header custom secondary text color=Пользовательский цвет дополнительного текста заголовка
Header custom text color=Нестандартный цвет текста заголовка
Header menu=Заголовок меню
Header show description=Описание показа заголовка
HHMM=ЧЧ:ММ
Hibernate VMs=Гибернация VMs
Hide dot files=Скрыть файлы с точкой
Host access to custom networks=Доступ хоста к пользовательским сетям
hosts=хостов
Hourly=Ежечасно
HTML color code of 3 or 6 hexadecimal digits=Код цвета HTML из 3 или 6 шестнадцатеричных цифр
HTTP port=порт HTTP
HTTPS port=порт HTTPS
Huge=Огромный
Identification=Идентификация
Import Tunnel=Импорт Туннеля
Importance=Важность
In most cases, this should be your public WAN IPv4 instead=В большинстве случаев это должен быть ваш общедоступный WAN IPv4
In most cases, this should be your public WAN IPv4=В большинстве случаев это должен быть ваш общедоступный WAN IPv4
In most cases, this should be your public WAN IPv6 instead=В большинстве случаев это должен быть ваш общедоступный WAN IPv6
In most cases, this should be your public WAN IPv6=В большинстве случаев это должен быть ваш общедоступный WAN IPv6
inactive=неактивный
Included disks=Включенный диск (ы)
Interface description=Описание интерфейса
Interface Rules=Правила интерфейса
Invalid data=Недействительные данные
Invalid email address=Неверный адрес электронной почты
Invalid IPv4 gateway=Недействительный шлюз IPv4
Invalid IPv4 range=Недействительный диапазон IPv4
Invalid IPv4 subnet=Недействительная подсеть IPv4
Invalid IPv6 gateway=Недействительный шлюз IPv6
Invalid IPv6 range=Недействительный диапазон IPv6
Invalid IPv6 subnet=Недействительная подсеть IPv6
Invalid pool address=Недействительный адрес пула
Invalid subnet size=Недействительный размер подсети
IP address or FQDN=IP-адрес или FQDN
IPv4 address A.B.C.D=IPv4-адрес A.B.C.D
IPv4 address assignment=Назначение адреса IPv4
IPv4 address=IPv4 адрес
IPv4 custom network on interface=Специальная сеть IPv4 на интерфейсе
IPv4 default gateway=Шлюз IPv4 по умолчанию
IPv4 DNS server assignment=Назначение DNS-сервера IPv4
IPv4 DNS server=DNS-сервер IPv4
IPv4 IPv6=IPv4 + IPv6
IPv4 network=сеть IPv4
IPv4 only=Только IPv4
IPv4nn or IPv6nn route=IPv4/nn или IPv6/nn маршрут
IPv6 address assignment=Назначение адреса IPv6
IPv6 address nnnnxxxxyyyy=IPv6-адрес nnnn:xxxx::yyyy
IPv6 address=IPv6 адрес
IPv6 custom network on interface=Специальная сеть IPv6 на интерфейсе
IPv6 default gateway=Шлюз по умолчанию IPv6
IPv6 DNS server assignment=Назначение DNS-сервера IPv6
IPv6 DNS server=DNS-сервер IPv6
IPv6 network=сеть IPv6
IPv6 only=Только IPv6
IPv6 privacy extensions=Расширение конфиденциальности IPv6
ipvlan=ipvlan
is down=не работает
is not in the=не находится в
Isolated CPUs=Изолированные CPUs
Isolation=Изоляция
Join=Присоединяйтесь
Key=Key
kyber=kyber
LAN hub spoke access=LAN-концентратор или звездообразный доступ
LAN to LAN access=Доступ LAN к LAN
Language update notification=Уведомления об обновлении языка
Language update=Обновление языка
Language=Язык
Large=Большой
Last day=Последний день
Last handshake=Последнее рукопожатие
Last week=На прошлой неделе
LE Cert Provisioned successfully=Сертификат LE успешно предоставлен
Leave=Оставлять
Libvirt Log=Журнал Libvirt
Libvirt storage location=Место хранения Libvirt
Libvirt vdisk size=Размер vdisk Libvirt
Libvirt version=Версия Libvirt
Libvirt volume info=Информация об объеме Libvirt
License key required=Нужен лицензионный ключ
List of peers=Список пиров
List of VLANs contains duplicate VLAN numbers=Список VLAN содержит повторяющиеся номера VLAN
Listing height=Высота списка
Loading=Загрузка
Local endpoint=Локальная конечная точка
Local gateway uses UPnP=Локальный шлюз использует UPnP
Local master=Локальный мастер
Local name=Локальное название
Local private key=Локальный закрытый ключ
Local public key=Локальный открытый ключ
Local server configuration=Конфигурация локального сервера
Local server uses NAT=Локальный сервер использует NAT
Local syslog folder=Локальная папка системного журнала
Local syslog maximum file size=Максимальный размер файла локального системного журнала
Local syslog number of files=Количество файлов в локальном системном журнале
Local syslog port=Локальный порт системного журнала
Local syslog rotation=Локальная ротация системного журнала
Local syslog server=Локальный сервер системного журнала
Local TLD=Локальный TLD
Local tunnel address IPv6=Адрес локального туннеля IPv6
Local tunnel address=Локальный адрес туннеля
Local tunnel firewall=Локальный туннельный брандмауэр
Local tunnel network pool IPv6=Пул локальной туннельной сети IPv6
Local tunnel network pool=Пул локальной туннельной сети
Lost communication=Потеряна связь
MAC address mismatch=Несоответствие MAC-адреса
MAC address=MAC-адрес
macvlan=macvlan
Mail server port=Порт почтового сервера
Mail server=Почтовый сервер
Manage password=Управлять паролем
Manage=Управлять
Management Access=Управление Доступом
mandatory=обязательным
Manual=Пособие
member of=участником
Metric=Метрическая
Mirror syslog to flash=Зеркало системного журнала для flash
Missing subnet size=Отсутствует размер подсети
MM-DD-YYYY=ММ-ДД-ГГГГ
ModBus=ModBus
Modify with caution unable to validate path until Array is Started=Измените осторожно: невозможно проверить путь, пока не будет запущен массив
Month of the year=Месяц года
Monthly=Ежемесячно
Move now=Переместить сейчас
Mover is running=Выполняется перемещение
Mover logging=Ведение журнала перемещения
Mover schedule=График перемещения
Mover Settings=Настройка Перемещения
mq-deadline=mq-дедлайн
MTU size=Размер MTU
Multi-function=Многофункциональный
Must be signed in to Unraidnet to provision cert=Чтобы предоставить сертификат, необходимо войти в Unraid.net
name or ip address=имя или ip-адрес
Net=Сеть
Network protocol=Сетевой протокол
Network Services=Сетевые Сервисы
Network Settings=Сетевые Настройки
Never check=Никогда не проверяйте
Never send=Никогда не отправляйте
New date and time=Новая дата и время
NFS=NFS
No Balance required=Баланс не нужен
No battery detected=Батарея не обнаружена
No Cache device present=Нет устройства Cache
No Cache disk present=Нет Cache-диска
No change to report=Нет изменений для отчета
No CPU pinning available. Docker service must be started=Нет доступного закрепления CPU. Необходимо запустить службу Docker
No CPU pinning available. VM service must be started=Нет доступного закрепления CPU. Необходимо запустить службу VM
no name=без названия
No Parity disk present=Диска четности нет
No Reply=безответный
Nominal Power=номинальная мощность
Non-tabbed=Без вкладок
Not activated=Не активирован
Not allowed to assign ZERO cores=Не разрешается назначать ноль ядер
Not compatible with NetBIOS=Несовместим с NetBIOS
not configured=не настроено
Not present=Не присутствует
not received=не получил
not set=не установлено
Not up-to-date=Неактуальный
not used=не используется
Nothing to do=Нечего делать
Notices=Сообщение
Notification Agents=Агенты сообщений
Notification entity=Субъект извещения
Notification Settings=Настройка уведомлений
Notifications display=Отображение уведомлений
NTP server=NTP сервер
Number format=Формат числа
Number scaling=Масштабирование чисел
Obtaining DNSv4 server=Получение сервера DNSv4
Obtaining DNSv6 server=Получение сервера DNSv6
Obtaining IPv4 address=Получение IPv4-адреса
Obtaining IPv4 gateway=Получение шлюза IPv4
Obtaining IPv6 address=Получение IPv6-адреса
Obtaining IPv6 gateway=Получение шлюза IPv6
obtaining=получение
On battery=от АКБ
One or more paths do not exist=Одного или нескольких путей не существует
Online boost=Онлайн (повышение)
Online trim=Онлайн (обрезка)
Online=Онлайн
Only alphanumeric characters=Только буквенно-цифровые символы
Only PNG images are allowed=Разрешены только изображения PNG
Oops=Упс
optional metric lowest is preferred, 0 is no default gateway=необязательный показатель (желательно самый низкий, 0 не является шлюзом по умолчанию)
optional metric lowest is preferred=необязательный показатель (желательно самый низкий)
or=или
Page view=Просмотр страницы
Parity Check=проверка на четность
Password=Пароль
Path does not exist=Пути не существует
PCIe ACS override=Замена ACS PCIe
PCnet=PCnet
Peer allowed IPs=Разрешенные IP-адреса
Peer DNS server=Узел DNS-сервер
Peer endpoint=Узел конечной точки
Peer name=Имя партнера
Peer preshared key=Предварительно общий ключ
Peer private key=Закрытый ключ однорангового пользователя
Peer public key=Одноранговый открытый ключ
Peer tunnel address IPv6=Адрес однорангового туннеля IPv6
Peer tunnel address=Адрес однорангового тоннеля
Peer type of access=Одноранговый тип доступа
Peer update required=Требуется одноранговое обновление
Persistent keepalive=Постоянное сохранение активности
Ping=Ping
Placement of Users menu=Размещение меню пользователей
Please consider re-applying all configurations=Пожалуйста, рассмотрите возможность повторного применения всех конфигураций
Please disable the VM function=Пожалуйста, отключите функцию VM
Please do this NOW=Пожалуйста, сделайте это сейчас
Please enter a valid gateway=Введите действительный шлюз
Please enter a valid range=Введите действительный диапазон
Please enter a valid sending email address=Пожалуйста, введите действительный адрес электронной почты для отправки
Please enter a valid subnet=Введите действительную подсеть
Please note that the flash backup is not encrypted at this time=Обратите внимание, что резервная копия flash-памяти пока не зашифрована.
Please Reboot system to make new rules active=Пожалуйста, **перезагрузите** систему, чтобы сделать новые правила активными
Plugins update notification=Уведомления об обновлениях плагинов
Plugins update=Обновление плагинов
Pool address is out of range=Адрес пула вне диапазона
Pool subnet size is not defined=Размер подсети пула не определен
Pool subnet size is too large=Размер подсети пула великоват
Port %s is already in use by other services=Порт %s уже используется другими службами
Port %s is duplicated=Порт %s дублируется
Port %s is out of range minimum 1 maximum 65535=Порт %s вне диапазона (минимум 1 максимум 65535)
Port already in use=Порт уже используется
Port Down=Порт Вниз
Port out of range=Порт вне зоны действия
Port Up=Порт Вверх
Preserve user defined networks=Сохранение определенных пользователем сетей
Preset service=Услуга предварительной настройки
Priority in header=Приоритет в заголовке
Protocol=Протокол
Provision=Обеспечение
QEMU version=Версия QEMU
readmodifywrite=прочитать/изменить/записать
recommended=рекомендовано
reconstruct write=реконструировать запись
Refreshing=Освежить
Registration key required=Требуется регистрационный ключ
Reinitialize=Повторная инициализация
Reinitializing=Повторная инициализация
Remark configure your router with port forwarding of port=Примечание: настройте маршрутизатор с переадресацией порта
Remark=Замечание
Remote access to LAN=Удаленный доступ к локальной сети
Remote access to server=Удаленный доступ к серверу
Remote peer configuration=Удаленная одноранговая конфигурация
Remote syslog port=Порт удаленного системного журнала
Remote syslog server=Удаленный сервер системного журнала
Remote tunneled access=Удаленный туннельный доступ
Remove Windows VirtIO driver ISO=Удалите драйвер ISO Windows VirtIO
Replied=Ответил
resolution=резолюция
Restore default image=Восстановить образ по умолчанию
Route=Маршрут
Routing Table=Таблица маршрутизации
Rule=Правило
Rules contain duplicate MAC address assignments=Правила содержат повторяющиеся назначения MAC-адреса
Rules=Правила
Runtime left to initiate shutdown=Время выполнения осталось для начала выключения
Runtime Left=Осталось время выполнения
Samba extra configuration=Дополнительная конфигурация Samba
Scheduled parity check=Плановая проверка на четность
Scheduler=Планировщик
Scrub=Scrub
Scrub schedule=График Scrub
Second week=Вторая неделя
See Help for more details and workarounds=Дополнительную информацию и обходные пути можно найти в справке
see interface=см. интерфейс
Send crash information to Unraid developers=Присылайте информацию о сбоях разработчикам Unraid
Send every hour=Отправлять каждый час
Send every two hours=Отправлять каждые два часа
Send four times a day=Отправлять четыре раза в день
Send once a day=Отправлять раз в день
Send once a month=Отправлять раз в месяц
Send once a week=Отправлять раз в неделю
Send three times a day=Отправлять трижды в день
Send twice a day=Отправлять дважды в день
Sending email address=Отправка электронного адреса
Server hub spoke access=Доступ к концентратору сервера и звездной сети
Server name=Имя сервера
Server to server access=Доступ от сервера к серверу
Server was unable to provision SSL certificate=Сервер не смог предоставить сертификат SSL
Set password=Установить пароль
Setting disabled in safe mode=Настройка выключена в **безопасном режиме**
Settings menu=Меню настроек
Show array utilization indicator=Показать индикатор использования массива
Show banner=Показать баннер
Show banner background color fade=Показать исчезновение цвета фона баннера
Show Dashboard apps=Показать программы на панели инструментов
Show Peer Config=Показать конфигурацию однорангового устройства
Shutdown time-out=Тайм-аут завершение работы
Shutdown VMs=Завершение работы VMs
shutdown=выключение
Sign In to Unraidnet required=Нужно войти в Unraid.net
Simple=Обычный
Small=Маленький
Smart=Умный
SMB Extras=SMB дополнение
SMB Settings=Настройка SMB
SMB=SMB
SMTP Settings=Настройка SMTP
SNMP=SNMP
Sorry, an error occurred in processing your SSL certificate=К сожалению, во время обработки вашего сертификата SSL произошла ошибка
Sorry, an error occurred updating unraidnet DNS records=К сожалению, при обновлении записей DNS unraid.net произошла ошибка
SSH port=порт SSH
Start APC UPS daemon=Запустите фоновую службу APC UPS
Start page=Стартовая страница
Static=Статический
Stop %s to make changes, see=Остановите **%s**, чтобы внести изменения, см
Stop corresponding docker containers=Остановить соответствующие docker-контейнеры
Store notifications to flash=Храните уведомления для flash
Subject=Тема
Subnet=Подсеть
subnet=подсеть
success=успешный
Summarized=Суммированные
Syslog Server=Сервер Syslog
System notifications=Системные уведомления
System Setting=Настройка системы
System Settings=Настройка систем
Tabbed=Вкладки
TCP=TCP
TELNET port=порт TELNET
Temperature unit=Единица температуры
Template Authoring Mode=Режим создания шаблонов
Terminal font size=Размер шрифта терминала
Test running=Тестовый запуск
Test=Тест
Text - Bar color=Текст-полоса (цвет)
Text - Bar gray=Текст-полоса (серая)
Text=Текст
The Local endpoint does not resolve to an IPv4 address=Локальная конечная точка не резолвиться в адрес IPv4
The Local endpoint does not resolve to an IPv6 address=Локальная конечная точка не резолвиться в адрес IPv6
The Local endpoint resolves to=Локальная конечная точка
The Local tunnel network pool cannot be in=Невозможно включить пул локальной туннельной сети
The Local tunnel network pool IPv6 cannot be in=Невозможно войти в пул локальной туннельной сети IPv6
Third week=Третья неделя
This is required to create VMs in KVM=Это необходимо для создания VMs в KVM
this mode requires a network switch with proper setup and support=для этого режима требуется сетевой коммутатор с правильной настройкой и поддержкой
this must be the only peer in the tunnel and sole active tunnel when in use=это должен быть единственный партнер в туннеле и единственный активный туннель во время использования
This removes any connections running over this tunnel=Это удаляет любые соединения, проходящие через этот туннель
This Unraid Server was unreachable from the outside=Этот сервер Unraid был недоступен извне
Time format=Формат времени
Time of the day=Время суток
Time on battery before shutdown=Время работы от аккумулятора до выключения
Time zone=Часовой пояс
time-out=время вышло
Timestamp=Отметка времени
TLS certificate location=Расположение сертификата TLS
to=к
Toggle keys=Клавиши переключения
Toggle thread to containers=Переключить поток на контейнеры
Toggle view=Переключить просмотр
top-left=вверху слева
top-right=вверху справа
Tunable enable Direct IO=Можно настроить (включить прямой IO)
Tunable enable NCQ=Можно настроить (включить NCQ)
Tunable fuse_remember=Возможность настройки (fuse_remember)
Tunable md_num_stripes=Возможность настройки (md_num_stripes)
Tunable md_queue_limit=Возможность настройки (md_queue_limit)
Tunable md_sync_limit=Возможность настройки (md_sync_limit)
Tunable md_write_method=Возможность настройки (md_write_method)
Tunable nr_requests=Возможность настройки (nr_requests)
Tunable poll_attributes=Возможность настройки (poll_attributes)
Tunable scheduler=Возможность настройки (scheduler)
Tunable support Hard Links=Возможность настройки (support Hard Links)
Tunnel has running containers attached=Тоннель имеет запущенные контейнеры
tunnel is inactive=туннель неактивен
Turn off UPS after shutdown=Выключите UPS после выключения
UDP=UDP
Unable to register this Unraid Server=Невозможно зарегистрировать этот Сервер Unraid
; Keep the original plugin name in settings=
Unassigned Devices=Неназначенные устройства
Unraid OS update notification=Уведомление об обновлении Unraid OS
Unraid OS update=Обновление Unraid OS
Unraidnet account status=Состояние учетной записи Unraid.net
Unraidnet Status=Статус Unraid.net
Update DNS=Обновите DNS
updating=обновление
Updating=Обновление
Upgrade Cert=Обновление Сертификата
UPnP forwarding not set=UPnP: пересылка не установлена
UPnP state changed to=Состояние UPnP изменено на
UPnP tunnel is inactive=UPnP: туннель неактивен
Upon host shutdown=После выключения хоста
UPS cable=Кабель UPS
UPS Details=Детали UPS
UPS Load=Нагрузка UPS
UPS Settings=Настройка UPS
UPS Status=Статус UPS
UPS type=Тип UPS
USB=USB
Use image name dockerimg or docker-xfsimg or select a folder=Используйте имя изображения docker.img или docker-xfs.img или выберите папку
Use NTP=Используйте NTP
Use only letters A-Z, digits or space,dash,underscore=Используйте только буквы A-Z, цифры или пробел, тире, подчеркивание
Use SSH=Используйте SSH
Use SSLTLS=Используйте SSL/TLS
Use STARTTLS=Используйте STARTTLS
Use TELNET=Используйте TELNET
Use UPnP=Используйте UPnP
Used Free columns=Применяемые/Свободные столбцы
User Preferences=Настройка пользователя
User root=Пользователь 'root'
User shares not enabled=Общие доступы пользователей не включены
User Utilities=Утилиты пользователя
Username=Имя пользователя
user-set=пользовательский набор
value must be a number=значение должно быть числом
Value=Значение
Very large=Очень большой
Very small=Ничтожно
VFIO allow unsafe interrupts=VFIO позволяет опасные прерывания
View libvirt log=Просмотр журнала libvirt
View Local Config=Просмотр локальной конфигурации
View Peer Config=Просмотреть конфигурацию однорангового устройства
view=просмотр
VLAN assignment mismatch=Несоответствие назначения VLAN
VLAN number=Номер VLAN
VM Manager=Менеджер VM
VM manager=менеджер VM
VM Settings A reboot is required to apply changes=Настройка VM: для применения изменений требуется перезагрузка
VM shutdown time-out=Время отключения VM
VM=VM
VMs only=Только VMs
VMs will be available after Array is Started=VMs будут доступны после запуска массива
VPN Manager=Менеджер VPN
VPN tunnel for docker containers only=VPN-туннель только для контейнеров докеров
VPN tunneled access=Туннельный доступ VPN
VPN tunneled access for docker=Туннельный доступ VPN для докера
VPN tunneled access for system=Туннельный доступ VPN для системы
WAN Port=Порт WAN
Warnings=Предупреждение
Watts=Ватт
Week of the month=Неделя месяца
Weekly=Еженедельно
WireGuard Configuration=Конфигурация WireGuard
Workgroup Settings=Настройка рабочей группы
Workgroup=Рабочая группа
Write corrections to parity disk=Записать исправление на диск четности
WSD options experimental=Параметры WSD [экспериментальный]
xfs vDisk=xfs vDisk
Yearly=Ежегодно
You must be signed in to Unraidnet in order to generate an Unraidnet SSL certificate=Вы должны войти в Unraid.net чтобы создать сертификат SSL Unraid.net
Your existing Docker image file needs to be recreated due to an issue from an earlier beta of Unraid 6=Ваш существующий файл образа Docker нужно восстановить из-за проблемы с предыдущей бета-версии Unraid 6
Your hardware does not have Intel VT-x or AMD-V capability=Ваше оборудование не поддерживает Intel VT-x или AMD-V
Your Lets Encrypt SSL Certificate has been provisioned and a DNS record for local IP address=Ваш сертификат Let's Encrypt SSL предоставлен и запись DNS для локального IP-адреса
Your Lets Encrypt SSL Certificate has been renewed=Ваш сертификат Let's Encrypt SSL обновлен
Your local IP address %s has been updated for unraidnet=Ваш локальный IP-адрес % s обновлен для unraid.net
Your router or DNS server has DNS rebinding protection enabled, preventing=На вашем маршрутизаторе или DNS-сервере включена защита от повторного привязывания DNS, что предотвращает
Your server has been registered=Ваш сервер зарегистрирован
Your Unraid Server is reachable from the internet=Ваш сервер Unraid доступен через Интернет
YYYY-MM-DD=ГГГГ-ММ-ДД

; My Servers plugin
Are you sure you want pause communication with your remote flash backup on unraidnet=Вы уверены, что хотите приостановить связь с удаленным резервным копированием на unraid.net?
Are you sure you want to erase all change history in both local and unraidnet remote=Вы уверены, что хотите стереть всю историю изменений как на локальном, так и на удаленном unraid.net?
Disabled until you Provision an unraidnet SSL Cert and set SSL-TLS to Auto=Выключено до тех пор, пока вы не предоставите сертификат unraid.net SSL и не установите SSL-TLS на Авто
Disabled until you Provision an unraidnet SSL Cert=Выключено до тех пор, пока вы не предоставите сертификат unraid.net SSL
Disabled until your root user account is password-protected=Отключено до тех пор, пока ваша учетная запись пользователя root не будет защищена паролем
Enable Transparent 2FA for Local Access=Включить прозрачную 2FA для локального доступа
Enable Transparent 2FA for Remote Access=Включить прозрачный 2FA для удаленного доступа
In order to activate Flash Backup there must be at least 1GB of free space on your flash drive=Чтобы активировать флеш-резервную копию, на флеш-накопителе должно быть не менее 1 ГБ свободного места.
Local T2FA requires a myunraidnet certificate=Для локального T2FA требуется сертификат *.myunraid.net
Local T2FA requires Unraid 610 or higher and a myunraidnet certificate=Для локального T2FA нужен Unraid 6.10 или выше и сертификат *.myunraid.net
Local T2FA requires Unraid 610 or higher=Для локального T2FA требуется Unraid 6.10 или выше
Local T2FA requires Use SSLTLS to be Auto and a myunraidnet certificate=Для локального T2FA нужно использовать SSL/TLS, чтобы быть автоматическим и сертификат *.myunraid.net
Local T2FA requires Use SSLTLS to be Auto and Unraid 610 or higher=Для локального T2FA нужно, чтобы параметр Use SSL/TLS был Автоматический и Unraid 6.10 или выше
Local T2FA requires Use SSLTLS to be Auto, Unraid 610 or higher, and a myunraidnet certificate=Местное T2FA требует, чтобы использование SSL/TLS автоматически, Unraid 6.10 или выше, а также сертификат *.myunraid.net
Local T2FA requires Use SSLTLS to be Auto=Для локального T2FA нужно использовать SSL/TLS, чтобы было автоматически
More information=Больше информации.
port=порт
Remote T2FA requires a myunraidnet certificate=Для удаленного T2FA требуется сертификат *.myunraid.net
Remote T2FA requires Remote Access to be enabled and a myunraidnet certificate=Для удаленного T2FA нужно включить удаленный доступ и сертификат *.myunraid.net
Remote T2FA requires Remote Access to be enabled and Unraid 610 or higher=Для удаленного T2FA нужно включить удаленный доступ и Unraid 6.10 или более поздней версии
Remote T2FA requires Remote Access to be enabled, Unraid 610 or higher, and a myunraidnet certificate=Для удаленного T2FA нужно включить удаленный доступ, Unraid 6.10 или более поздней версии и сертификат *.myunraid.net
Remote T2FA requires Remote Access to be enabled=Для удаленного T2FA необходимо включить удаленный доступ
Remote T2FA requires Unraid 610 or higher and a myunraidnet certificate=Для удаленного T2FA нужны Unraid 6.10 или более поздней версии и сертификат *.myunraid.net
Remote T2FA requires Unraid 610 or higher=Для удаленного T2FA требуется Unraid 6.10 или более поздней версии
The Unraid server is unreachable from outside your network Be sure you have configured your router to forward port=Сервер Unraid недоступен из-за пределов вашей сети. Убедитесь, что вы настроили маршрутизатор на переадресацию порта
to the Unraid server at=на сервер Unraid по адресу
Transient errors in this log can be ignored unless you are having issues=Временные ошибки в этом журнале можно игнорировать, если у вас не возникли проблемы
Unraid API extra origins=Дополнительные источники API Unraid
View Flash Backup Error Log=Просмотреть журнал ошибок Flash Backup

; Note: June 19, 2022 - 3 missing translations
