Add Share=Добавить ресурс
All files encrypted=Все файлы зашифрованы
All files protected=Все файлы защищены
All files unprotected=Все файлы незащищены
Allocation method=Метод распределения
Array must be Started to view Shares=Чтобы просмотреть общие ресурсы, массив должен быть **запущен**
Automatically split any directory as required=Автоматически разделит любой каталог по необходимости
Automatically split only the top five directory levels as required=При необходимости автоматически разделит только пять верхних уровней каталога
Automatically split only the top four directory levels as required=При необходимости автоматически разделит только четыре верхних уровня каталога
Automatically split only the top level directory as required=При необходимости автоматически разделит только каталог верхнего уровня
Automatically split only the top three directory levels as required=При необходимости автоматически разделит только три верхних уровня каталога
Automatically split only the top two directory levels as required=При необходимости автоматически разделит только два верхних уровня каталога
Comments=Комментарии
Compute All=Рассчитать Все
Compute=Рассчитать
Disk Shares=Общие диски
Do not use reserved names=Не используйте зарезервированные имена
Do not use pool names=Не используйте названия пулов
Enable Copy-on-write=Включить копирование во время записи
Enter a name for the share=Введите имя для совместного использования
Excluded disks=Исключенные диски
Export=Экспорт
Fill-up=
Free=Свободно
has been deleted=было удалено
HDD=HDD
High-water=
Included disks=Включенный диск (и)
Invalid Characters=Недопустимые символы
Invalid share name=Недействительное название общей папки
Manual do not automatically split directories=Инструкция: не разделять каталоги автоматически
Minimum free space=Минимум свободного места
Missing share name=Отсутствует название общего ресурса
Most-free=
Mover takes no action=Инициатор не принимает никаких мер
Mover transfers files from array to cache=Инициатор передает файлы из массива в кэш
Mover transfers files from cache to array=Инициатор передает файлы из кэша в массив
next user share=общий доступ следующего пользователя
Only=Только
Prefer=Предпочитать
previous user share=предыдущий пользователь
Read=Прочитать
Recompute=Пересчитать
Rule=Правило
Select cache pool=Выберите пул кэша
Set when adding new share only=Устанавливается только при добавлении нового совместного доступа
Share contains data=Общий доступ содержит данные
Share is empty=Общий доступ пустой
Share is outside the list of designated disks=Общий доступ находится за пределами списка назначенных дисков
Share Settings=Настройка совместного доступа
Share status=Поделиться статусом
Size=Размер
Some or all files unencrypted=Некоторые или все файлы незашифрованы
Some or all files unprotected=Некоторые или все файлы не защищены
Split level=Разделенный уровень
SSD=SSD
There are no exportable disk shares=Нет общих дисков для экспорта
There are no exportable user shares=Нет общих пользователей, которые можно экспортировать
Time Machine volume size limit=Ограничение размера объема Time Machine
Unknown encryption state=Неизвестное состояние шифрования
Use cache pool for new filesdirectories=Использовать пул кэша (для новых файлов/каталогов)
User Shares=Общие доступы пользователей
Write=Писать
You cannot use the following within share names=Вы не можете использовать следующее в именах общего доступа
