20 EHCI=2.0 (EHCI)
30 nec XHCI=3.0 (nec XHCI)
30 qemu XHCI=3.0 (qemu XHCI)
Allocation=Выделение
and if using graphics device passthrough it too needs UEFI=и если используется пропускной режим графического устройства, ему также нужен UEFI
Are you sure=Вы уверены
Array must be started to view Virtual Machines=Для использования виртуальных машин необходимо **запустить** массив
Autostart=Автостарт
Back=Назад
Bus=Шина
Capacity=Способность
Change Icon=Изменить иконку
Cleanup=Убирать
Click and Select cdrom image to install operating system=Нажмите и выберите образ cdrom, чтобы установить операционную систему
Config Folder=Папка конфигурации
Copy Paste Domain XML Configuration Here=Копировать & amp; вставьте сюда конфигурацию XML домена
CPU Mode=Режим CPU
CPUs=Ядра
Create=Создать
Creating=Создание
define the amount memory=определите объем памяти
define the maximum amount of memory=определите максимальный объем памяти
define type of cpu presented to this vm=определите тип cpu, предоставленного этой виртуальной машине
description of virtual machine=описание виртуальной машины
Disk devices=Дисковые устройства
Download Folder=Скачать папку
Download, Click and Select virtio drivers image=Загрузите, выберите образ virtio драйверов
Downloading=Загрузка
eg=e.g.
Emulated=Эмулируется
ETA=ETA
Extracting=Извлечение
Folder to save the LibreELEC image to=Папка для сохранения образа LibreELEC
Folder to save the OpenELEC image to=Папка для сохранения образа OpenELEC
Form View=Просмотр формы
free=свободно
Graphics Card=Видеокарта
Graphics ROM BIOS=Графический ROM BIOS
Graphics=Графика
Guest not running or guest agent not installed=Гость не запущен или гостевой агент не установлен
Host Passthrough=Передача хоста
Hyperv tweaks for Windows=Настройка Hyperv для Windows
Hyper-V=Hyper-V
i440fx will work for most=i440fx подойдет для большинства
Icon=Иконка
Initial=Начальный
Interfaces=Интерфейсы
Invalid storage path=Недействительный путь хранения
Invalid VM to edit=Недействительная VM для редактирования
IP Address=IP-адрес
ISO storage path doesnt exist=Путь к хранению ISO не существует
ISO storage path doesnt exist, please create the user share or empty folder first=Путь к хранению ISO не существует, сначала создайте пользователя с общим доступом (или пустую папку)
ISO storage path was empty=Путь к хранению ISO пуст
keyboard for VNC=клавиатура для VNC
LibreELEC Version=Версия LibreELEC
LibreELEC=LibreELEC
Libvirt Service failed to start=Не удалось запустить службу Libvirt
Logical CPUs=Логические CPUs
Machine=Машина
Manual=Мануал
Max=Максимальный
MD5 verification failed, your download is incomplete or corrupted=Ошибка проверки MD5, ваша загрузка неполная или повреждена
mount tag inside vm=тег монтирования внутри vm
My Workstation=Моя рабочая станция
name of mount tag inside vm=имя тега монтирования внутри vm
Name of virtual machine=Имя виртуальной машины
Network Bridge=Сетевой Bridge
Network MAC=MAC адрес
Network Model=Модель сети
No Virtual Machines installed=Виртуальные машины не установлены
None available=Нет в наличии
Not enough free space, need at least=Не хватает свободного места, нужно по крайней мере
Not running=Не запущено
OpenELEC Version=Версия OpenELEC
OpenELEC=OpenELEC
OS Install CDRom Bus=ОС установить шину CDROM
OS Install ISO=ОС установите ISO
Other PCI Devices=Другие PCI устройства
OVMF requires a UEFI-compatable OS=OVMF требует UEFI-совместимой ОС
OVMF=OVMF
OVMF TPM=OVMF TPM
password for VNC=пароль для VNC
path of Unraid share=путь совместного доступа Unraid
path on Unraid share to save LibreELEC settings=путь к совместному доступу Unraid, чтобы сохранить настройки LibreELEC
path on Unraid share to save OpenELEC settings=путь к совместному доступу Unraid, чтобы сохранить настройки OpenELEC
Path to ROM BIOS file=Путь к файлу ROM BIOS
Please choose a folder the LibreELEC image will download to=Пожалуйста, выберите папку, в которую будет загружено изображение LibreELEC
Please choose a folder the OpenELEC image will download to=Пожалуйста, выберите папку, в которую будет загружено изображение OpenELEC
Pop-up Blocker is enabled Please add this site to your exception list=Блокировщик всплывающих окон включен! Пожалуйста, добавьте этот сайт в список исключений
Prefix=Префикс
Primary=Первичный
Q35 for a newer machine model with PCIE=Q35 для более новой модели машины с PCIE
QEMU64=QEMU64
random mac, you can supply your own=случайный mac адрес, вы можете выбрать свой собственный
re-generate random mac address=Генерировать случайный mac-адрес
Remove LibreELEC image=Удалить образ LibreELEC
Remove OpenELEC image=Удалить образ OpenELEC
Remove this LibreELEC file=Удалить этот файл LibreELEC
Remove this OpenELEC file=Удалить этот файл OpenELEC
SeaBIOS will work for most=SeaBIOS подойдет для большинства VM
SeaBIOS=SeaBIOS
Select the BIOS=Выберите BIOS
Select the LibreELEC version to use=Выберите версию LibreELEC для использования
Select the machine model=Выберите модель машины
Select the OpenELEC version to use=Выберите версию OpenELEC для использования
Select the USB Controller to emulate=Выбрать контроллер USB для эмуляции
Separate sub-folder and image will be created based on Name=На основе имени будет создана отдельная подпапка и образ
shares=общий доступ
Some OSes wont support USB3=Некоторые ОС не поддерживают USB3
Sound Card=Звуковая карта
Specify a ISO storage path first=Сначала укажите путь хранения ISO
Start All=Запустить все
Start VM after creation=Запустить виртуальную машину после создания
Stop All=Остановить все
Toggle VM autostart=Включить автозапуск VM
type of storage image=тип образа для хранения
Unknown action=Неизвестное действие
Unknown version=Неизвестная версия
Unraid Mount tag=Тег монтирования Unraid
Unraid Share=Общий доступ Unraid
Updating=Обновление
USB Controller=USB-контроллер
USB Devices=USB-устройства
vDisk Bus=шина vDisk
vDisk Location=Расположение vDisk
vDisk Size=Размер vDisk
vDisk Type=Тип vDisk
vDisks=vDisks
Verifying=Проверка
video for VNC=видео для VNC
VirtIO Drivers CDRom Bus=Драйверы VirtIO шины CDROM
VirtIO Drivers ISO=Драйверы VirtIO ISO
Virtual Machines=Виртуальные Машины
VM creation error=Ошибка создания VM
VM image deletion error=Ошибка удаления образа VM
VNC Keyboard=Клавиатура VNC
VNC Password=Пароль VNC
VNC Video Driver=Видео драйвер VNC
VNC=VNC
Wasnt able to stop the process=Не удалось остановить процесс
Windows 7XP=Windows 7/XP
Windows 82012, newer Linux distros=Windows 8/2012, более новые дистрибутивы Linux
XML View=Просмотр XML
