Cancel=Аннулировать

; My PSAs / banners
Happy New Year=Счастливого Нового Года
Happy Holidays from Andrew, Tracey, and family=Веселых праздников от Эндрю, Трейси и семьи
Please Enjoy Responsibly=Пожалуйста, наслаждайтесь ответственно
Popup Blocked CA requires popups to be enabled under certain circumstances You must white list your server within your browser to allow popups=Всплывающие окна заблокированы CA требует, чтобы всплывающие окна были включены при определенных обстоятельствах. Чтобы разрешить всплывающие окна, ваш сервер должен быть в белом списке в вашем браузере
Docker Service Not Enabled - Only Plugins Available To Be Installed Or Managed=Служба Docker не включена – только плагины доступны для установки или управления
Docker system failed to start - Only Plugins Available To Be Installed Or Managed=Не удалось запустить систему Docker – доступны только плагины для установки или управления
Array not started - Only Plugins Available To Be Installed Or Managed=Массив не запущен – доступны только плагины для установки или управления
Community Applications works best when cookies are enabled in your browser Certain features may not be available=Программы сообщества работают лучше всего, когда в вашем браузере включены файлы cookie. Некоторые функции могут быть недоступны
Backup Server Active Some icons may not appear, and plugin installations may be affected=Сервер резервного копирования активен некоторые значки могут не отображаться, и это может повлиять на установку плагинов
Debugging enabled This significantly increases the memory used by your browser=Включена настройка. Это значительно увеличивает объем памяти, который использует Ваш браузер
Browser translation detected Display issues may result=Обнаружен перевод браузера. Могут возникнуть проблемы с отображением
Running Background Application Tests=Запуск тестов фоновой программы
Action Centre Enabled=Центр поддержки включен

; Sorting Options
Sort By=Сортировать по
Name Ascending=Название по возрастанию
Name Descending=Название по убыванию
Downloads=Загрузка
Date Added=Дата добавлена
Number Of Apps=Количество Программ
; Initial disclaimer translations=
Disclaimer=Отказ от ответственности
All applications listed here are 3rd party additions to Unraid Neither the authors of Community Applications nor Limetech make any warranty as to the suitability of any application listed here=Все программы, перечисленные здесь, являются сторонними приложениями к Unraid. Ни авторы программ сообщества, ни Limetech не дают никаких гарантий относительно пригодности любой программы, перечисленной здесь
Every attempt is made to ensure that only safe and compatible applications are present=Предприняты все усилия для обеспечения наличия только безопасных и совместимых программ
Application Policy=Политика применения
I Understand=Я понимаю
Installations of apps disabled You must accept the warning to be able to install applications=Установка приложений отключена. Чтобы иметь возможность устанавливать программы, нужно принять предупреждение
Click here=Нажмите здесь
%s Results Per Page=%s результатов на страницу
Results Per Page: %s=Результаты на странице: %s

; Plugin Disclaimer
Community Applications contains both docker containers and plugin applications Plugins are designed for OS enhancements, and run with full privileges on your system and are clearly identified within CA=Приложения сообщества содержат как контейнеры докеров, так и приложения плагинов. Плагины разработаны для улучшения ОС и работают с полными привилегиями в вашей системе и четко определены в CA
Plugin Note=Примечание Плагина

; Multi Install
Install Plugin Applications=Установить приложения плагинов
Select all on page=Выберите все на странице
Install Application=Установить приложение
Install Applications=Установить приложения
Update Applications=Обновление приложений
Are you sure you want to update %s applications=Вы уверены, что хотите обновить программы %s
Are you sure you want to install %s docker and %s plugin applications=Вы уверены, что хотите установить докер %1$s и приложения плагинов %2$s

; Searches
Search=Поиск
Click Here To Get More Results From DockerHub=Нажмите здесь, чтобы получить дополнительные результаты от DockerHub
No Matching Applications Found=Не найдено соответствующих программ

; Repository Related
%s removed as favourite repository=%s удален как любимый репозиторий
%s set as favourite repository=%s установлен как любимый репозиторий
Click to remove favourite repository=Нажмите, чтобы удалить любимый репозиторий
Click to set %s as favourite repository=Нажмите, чтобы установить %s как любимый репозиторий
Search for apps in repository=Поиск программ в репозитории
No description present=Нет описания
Go to the forum page=Перейдите на страницу форума
Go to the webpage=Перейти на веб-страницу
Go to reddit=Перейти к reddit
Go to facebook=Перейти к facebook
Go to discord=Перейти к discord
Go to forum profile=Перейти к профилю форума
Show Profile=Показать профиль
SHOW MORE=ПОКАЗАТЬ БОЛЬШЕ
SHOW LESS=ПОКАЗАТЬ МЕНЬШЕ
Read more=Подробнее
Total Applications=Всего заявок
Total Known Downloads=Общее количество известных загрузок
Total Docker Applications=Всего программ Docker
Total Plugin Applications=Всего Приложений Плагинов
Total Languages=Всего языков
Average Downloads Per App=Среднее количество загрузок на приложение
Web Page=Веб-страница
Forum=Форум
Forum Profile=Профиль Форума
Profile=Профиль
Facebook=Facebook
Reddit=Reddit
Twitter=Twitter
Discord=Discord
Search Apps=Поиск Приложений
Registry=Реестр
Details=Детали
Added=Додать
; Install Plugin title of openbox=
Install Plugin=Установить плагин
Update Plugin=Обновить плагин

Requirements not met=Требования не выполнены
The requirements for this upgrade have not been met on your system=Требования для этого обновления не были выполнены в вашей системе

BACK=ОБРАТНО

; Remove App from previously installed
Delete Template=Удалить шаблон
Yes, delete it=Да, удалить

; Uninstall popup
Uninstall Application=Удалить Приложение
Yes uninstall it=Да, удалить его

; Remove Private Application
Remove Private Application=Удалить частное приложение
Yes, remove it=Да, удалить

; App Pinning
Click to pin this application=Нажмите, чтобы закрепить это приложение
Click to unpin this application=Нажмите, чтобы открепить эту программу
Pin App=Закрепить приложение
Unpin App=Открепить приложение

; Branch installations
Choose A Branch To Install=Выберите ветку для установки

; Multiple application installs
; no apps selected
Install Selected Applications=Установите выбранные приложения

Yes, install it=Да, установить

; Multi-install popup
Yes, install them=Да, установить их
Cookies not enabled Plugins must be separately installed from docker applications=Файлы cookie не включены. Плагины необходимо устанавливать отдельно от программ Docker
Docker applications will be installed utilizing the most recently saved template with no user input on your part=Программы Docker будут установлены с использованием последнего сохраненного шаблона без ввода с вашей стороны
Updating Support Links=Обновление ссылок поддержки
Downloading docker icons=Загрузка иконок докеров
Finished Installing If the DONE button did not appear, then you will need to click the red X in the top right corner=Установка завершена Если кнопка ГОТОВО не появилась, вам нужно будет нажать красный X в верхнем правом углу

; error messages
No data was returned It is probable that another browser session has rebooted your server Reloading this browser tab will probably fix this error=
An error occurred Could not find any %s Apps=
Download of appfeed failed=
; the %s here refers to a function being called
Something really went wrong here=
Post the ENTIRE contents of this message in the Community Applications Support Thread=
Unknown error happened Please post a screenshot in the support thread of the Statistics screen=
Something really wrong happened Reloading the Apps tab will probably fix the problem=
This plugin has a duplicated name from another plugin %s This will impact your ability to install both plugins simultaneously=
You have been logged out=
Fatal Flash Drive Error=
This usually means your flash drive is corrupted or has dropped offline The rest of the Unraid GUI will also be affected Post a new thread in the Unraid forums if this error continues=
Fatal Docker Image Error=
Your docker image or folder is either read-only or completely full Issues will result because of this You should create a new post in the Unraid forums and include your diagnostics=
This template is set up to use a custom network You may have to adjust the network or IP address etc to match your system=
One or more ports used by this application are already in use by another service or app running on your server You will need to adjust the host ports accordingly on the template=

; CA Sections Keep the length reasonable
Home=Главная
Installed Apps=Установленные Приложения
Previous Apps=Предыдущие Приложения
Pinned Apps=Закрепленные Приложения
Favourite Repo=Любимое репо
Action Centre=Центр действий
Recently Added=Недавно добавленные
Random Apps=Случайные программ
Top New Installs=Самые новые инсталляции
Top Trending Apps=Самые популярные приложения
Spotlight Apps=Приложения Центра внимания
All Apps=Все Приложения
Statistics=Статистика
Credits=Заслуга
Support=Поддержка
VERSION=ВЕРСИЯ
Change Log=Журнал изменений
Debugging=Налаживание

; Credits
Development=Разработчик
Additional Contributions=Дополнительные взносы
GUI Layout Design=Дизайн макета графического интерфейса
Application Feed=Канал программы
Additional Testing=Дополнительное Тестирование
Moderation=Модерация
Additional Libraries=Дополнительные библиотеки
Copyright=Авторское право
Translation=Перевод

; Statistics page

unknown=неведомо
Last Change To Application Feed=Последнее изменение канала программы
Docker Applications=Программы Docker
Plugin Applications=Приложения Плагинов
Templates=Шаблоны
Official Containers=Официальные Контейнеры
Repositories=Репозитории
Private Docker Applications=Частные приложения Docker
Invalid Templates=Недействительные Шаблоны
Template Errors=Ошибки шаблона
Blacklisted Apps=Приложения из черного списка
Incompatible Applications=Несовместимые приложения
Deprecated Applications=Устаревшие программы
Moderation Entries=Модерация записей
Primary Server=Основной сервер
Backup Server=Сервер резервного копирования
Installs not allowed from this page=Установка с этой страницы запрещена

; Statistics Popup
No invalid templates found=Недействительных шаблонов не найдено
These templates are invalid and the application they are referring to is unknown=Эти шаблоны недействительны, а программа, на которую они ссылаются, неизвестна
No templates were automatically fixed=Ни один шаблон не исправлен автоматически
All of these errors found have been fixed automatically=Все эти обнаруженные ошибки были исправлены автоматически
Note that many of these errors can be avoided by following the directions=Обратите внимание, что многие из этих ошибок можно избежать, следуя инструкциям
HERE=ЗДЕСЬ
The following plugins have duplicated filenames and are not able to be installed simultaneously=Следующие плагины имеют дублированные имена файлов, поэтому их невозможно установить одновременно
The following docker applications refer to the same docker repository but may have subtle changes in the template to warrant this=Следующие программы докеров ссылаются на то же хранилище докеров, но могут иметь незначительные изменения в шаблоне, чтобы гарантировать это
If any of these entries are incorrect then contact the moderators of CA to discuss=Если какая-либо из этих записей неверна, обратитесь к модераторам CA для обсуждения
Global Repository Comments=Комментарии глобального хранилища
Applied to all applications=(Применяется ко всем программам)
Individual Application Moderation=Модерация Применения

; Misc
Community Applications Changelog=Журнал изменений приложений сообщества

Each month we highlight some of the amazing work from our community=Каждый месяц мы освещаем некоторые удивительные работы нашего сообщества
Check out these newly added applications from our awesome community=Просмотрите эти Недавно добавленные приложения из нашего замечательного сообщества
Check out these up and coming apps=Просмотрите эти новые приложения
These apps have the highest percentage of new installs=Эти программы имеют самый высокий процент новых установок
An assortment of randomly chosen apps=Ассортимент случайно выбранных программ

; Categories try not to be excessively long This is displayed on the left of CA screen

Backup=Резервное Копирование
Cloud=Cloud
Crypto Currency=Крипто Валюта
Downloaders=Загрузчики
Drivers=Драйверы
Game Servers=Игровые Серверы
Home Automation=Автоматизация Дома
Media Applications=Медиа-Приложения
Books=Книги
Music=Музыка
Photos=Фотографии
Video=Видео
Other=Прочие
Media Servers=Медиа-Серверы
Network Services=Сетевые Сервисы
DNS=DNS
FTP=FTP
Management=Менеджмент
Messenger=Мессенджер
Proxy=Proxy
VOIP=VOIP
VPN=VPN
Web=Web
Privacy=Приватность
Productivity=Производительность
Security=Безопасность
Spotlight=Центр внимания
Tools Utilities=Средства / Утилиты
System=Система
Themes=Темы
Utilities=Утилиты
Private Apps=Частные программы
Uncategorized=Без категории

; Categories displayed within a popup or on the card.  Where an entry exists after the "=it is not translated, but rather how it should look
GameServers=Игровые серверы
HomeAutomation=Автоматизация Дома
MediaApp=Медиа-Приложения
MediaAppBooks=MediaApp:Books
MediaAppMusic=MediaApp:Music
MediaAppPhotos=MediaApp:Photos
MediaAppVideo=MediaApp:Video
MediaAppOther=MediaApp:Other
MediaServer=Медиа Сервер
MediaServerBooks=MediaServer:Books
MediaServerMusic=MediaServer:Music
MediaServerPhotos=MediaServer:Photos
MediaServerVideo=MediaServer:Video
MediaServerOther=MediaServer:Other
Network=Сеть
NetworkDNS=Network:DNS
NetworkFTP=Network:FTP
NetworkManagement=Network:Management
NetworkProxy=Network:Proxy
NetworkVOIP=Network:VOIP
NetworkVPN=Network:VPN
NetworkPrivacy=Network:Privacy
NetworkWeb=Network:Web
NetworkOther=Network:Other
ToolsSystem=Tools:System
ToolsThemes=Tools:Themes
ToolsUtilities=Tools:Utilities
OtherUncategorized=Other:Uncategorized
and %s more=и еще %s

; App Popup Related
This application template has been blacklisted=Это приложение / шаблон занесено в черный список
This application template has been deprecated=Это приложение / шаблон устаревший
This application has additional requirements=Это приложение имеет дополнительные требования
Additional Requirements=Дополнительные требования
Donate To Author=Пожертвовать автору
Donate To Maintainer=Пожертвовать сопровождающему
CLOSE=ЗАКРЫТЬ
Author=Автор
Maintainer=Сопровождающий
DockerHub=DockerHub
Application Template=
DockerHub Stars=
Added to CA=
Date Updated=
Current Version=
Min OS=
Max OS=
Total Downloads=
Licence=
Ranked #%s=
; as in Trending up or down arrow
Trending %s=
; as in As of some date
As of %s=(As of %s)
Play Video=
Play Video %s=
This application is not compatible with your version of Unraid=
Another browser tab or device has updated the displayed templates Some actions are not available=Another browser tab or device has updated the displayed templates. Some actions are not available
WebUI=
Reinstall=
Reinstall From Previous Apps=
Install=
Uninstall=
Project=
Read Me First=
Install second instance=
Install Using The Templates Default Tag=Install Using The Template's Default Tag
Moderator Comments=Moderator Comments:
Note not all authors keep up to date on change logs=
Note not all maintainers keep up to date on change logs=
Last Update=
Note All statistics are only gathered every 30 days=
;the following if using a space you MUST use nbsp but keep it down to one word if at all possible
Donate=
Currently Installed Version=
Install The Update=
; as in you have the latest version already installed
Latest Version=
Multi Language Support=
Support Forum=
; as in more than 100000
More than %s=
Remove from Previous Apps=
Remove=
See All Apps=
Favourite=
Application Type=

; Graphs
Trend Per Month=Тенденция за месяц
Downloads Per Month=Загрузка на месяц

; Multi install script
Installing docker applications %s=Установка docker-программ %s
Starting %s=Запуск %s
%s failed to start You should install it by itself to fix the errors=Не удалось запустить %s. Вы должны установить его самостоятельно, чтобы исправить ошибки
Setting installed applications to autostart=Настройка установленных программ на автозапуск
Docker Application Installation finished=Установка приложения Docker завершена

; Application Cards
Actions=Действия
This application is a driver plugin=Это приложение является драйвером (плагином)
This is a language pack=Это языковой пакет
This application is a docker container=Это приложение является Docker-контейнером
This application is a plugin=Это приложение является плагином
This is a spotlight application=Это программа для привлечения внимания
This is your favourite repository=Это ваше любимое хранилище
This application is from your favourite repository=Это приложение из вашего любимого хранилища
This application is pinned for later viewing=Это приложение закреплено для последующего просмотра
Private Application=Частное Применение
Remove Application From List=Удалить программу из списка
Check off to select multiple reinstalls=Установите флажок, чтобы выбрать несколько повторных инсталляций
Go to the plugin settings=Перейдите к настройкам плагина
Click to reinstall the application using default values=Нажмите, чтобы переустановить приложение, используя значения по умолчанию
Click to edit the application values=Нажмите, чтобы изменить значение приложения
Click to reinstall=Нажмите, чтобы переустановить
Click to install=Нажмите, чтобы установить
Click to go to the WebUI=Нажмите, чтобы перейти к WebUI
This application template has been deprecated=Этот шаблон программы устарел
This application template has been blacklisted=Этот шаблон программы внесен в черный список
Click info to see the notes regarding this application=Нажмите информацию, чтобы просмотреть примечания по этому приложению
This application has additional requirements=Это приложение имеет дополнительные требования
BETA=БЕТА
INSTALLED=Установлено
OFFICIAL=ОФИЦИАЛЬНЫЙ
UPDATED=Обновлено
This is an official container=Это официальный контейнер
Digitally Signed=Цифровая подпись
This container is digitally signed=Этот контейнер имеет цифровую подпись
Docker Hub=Docker Hub
NOTE You must visit the dockerHub page to gather the information required to install correctly=ПРИМЕЧАНИЕ Вы должны посетить страницу dockerHub, чтобы собрать информацию, необходимую для правильной установки
Show CA templates=Показать шаблоны CA
Deprecated=Устаревшее
Incompatible=Несовместимые
Blacklisted=Черный список
Template Exists=Шаблон существует
Template already exists in Apps=Шаблон уже существует в приложениях
; eg: LinuxServer Repository
%s Repository=%s Репозиторий
; eg: Squid's Repository
%s's Repository=%s's Репозиторий

Info=Информация
Attention=Внимание
Repository=Репозиторий
Why we picked it=Почему мы выбрали это
Application Spotlight %s=Программа в центре внимания %s
Unraid Staff=Unraid Персонал

; Page Navigation
Displaying %s - %s of %s=Отображение%1$s - %2$s (с %3$s)

Updating Content=Обновление содержимого
Language=Язык
Switch to this language=Перейти на этот язык
Country Code=Код Страны
Install Language Pack=Установить языковой пакет
Remove Language Pack=Удалить языковой пакет
Update Language Pack=Обновить языковой пакет
Installed Version=Установленная версия
A note about translations=Примечание о переводах
Click here to view the language changelog=Нажмите здесь, чтобы просмотреть журнал изменений языка
View Missing Translations=Просмотреть недостающие переводы

; Update Checks
Check For Updates=Проверить наличие обновлений
Check for updates already running=Проверьте, уже ли запущены обновления
Checking for docker container updates=Проверка обновлений контейнера Docker
Checking for plugin updates=Проверка обновлений Плагинов
Checking for language updates=Проверка обновлений языка
Checking %s=Проверка %s

; dockerHub conversions
Determine configuration=Определить конфигурацию
Would you like CA to attempt to determine any applicable paths, ports, and variables for the template This will entail performing a test installation of the container It will be automatically deleted after processing The container will not be started=Желаете ли вы, чтобы ЦС попытался определить любые применимые пути, порты и переменные для шаблона? Для этого нужно выполнить пробную установку контейнера. Он будет автоматически удален после обработки. Контейнер не запускается.
An error occurred - Could not determine configuration=Произошла ошибка, Не удалось определить конфигурацию
; WebGui
Click Install to download and install the Community Applications plugin=Нажмите **Установить**, чтобы загрузить и установить плагин **приложения сообщества**


; Note: June 25, 2022 - 220 missing translations
